###############################
               #              #
##### ############## ##### ####
##       ## #        #        #
## ## ##### ## ########### ####
## ##    ##       ##          #
## ## ## ## ######## ##### ## #
## ## ##    ## #     #     #  #
######## ##### ######## #######
##    ##    ##    ##          #
## ##### ##### ## ######## ####
##    ##       ##    #        #
##### ## ############## ## ####
##       ## ## ##       #     #
##### ## ## ## ## ## ##########
##    ## ## ##    ##          #
######## ## ######## ##### ## #
##    ## ##    ## #   #    ## #
## ## ## ## ##### ##### ##### #
## ##    ##                ## #
############################# #
